++++++++++++++++++++++
+   +   ++ ++        +
C     +  C  ++++++++++
+ +    ++  ++++ +++ ++
+ +   + + ++    +++  +
+     M M  ++  ++  + +
+++++ + +     C++  + +
+++++ +++  + +  ++   +
+          + + S+ +  +
+++++ +  + + + M   + +
++++++++++++++++++++++